{
  "name": "古墓地带 · 入口区域 v2",
  "tileset": "graveyard",
  "tile_size": 32,
  "width": 80,
  "height": 22,

  "_design_notes": [
    "==== 地图设计文档（第 7 阶段重制） ====",
    "尺寸：80 × 22 瓦片（2560 × 704 像素），可水平横版滚屏。",
    "",
    "[跳跃高度计算（必须遵守）]",
    "  config.py: JUMP_FORCE=-480, GRAVITY=900, PLAYER_SPEED=240",
    "  最大垂直跳跃高度 = 480² / (2*900) = 128 px = 4 行",
    "  所以单次跳跃可上升至多 3 行平台（96 px），余 32 px 容错",
    "  最大水平跳跃距离（同高）= 240 * (2*480/900) ≈ 256 px = 8 列",
    "  跳到高 96 px 的平台时，水平窗口 = 64~192 px = 2~6 列",
    "",
    "[平台分层]",
    "  row 17 = 主地面（含可跳过的小坑）",
    "  row 14 = 第一层平台 (距地 96px = 3 行) ← 始终从主地面单跳可达",
    "  row 11 = 第二层平台 (距 row 14 = 96px) ← 从 row 14 单跳可达",
    "  row 8  = 第三层平台 (距 row 11 = 96px) ← 从 row 11 单跳可达",
    "",
    "[5 大区段]",
    "  A. 起始营地     (cols 1-15)  cf_01 + 训练步兵 1 名",
    "  B. 废弃工坊     (cols 16-30) 第一组 archer + 浅坑挑战",
    "  C. 墓室垂直爬升 (cols 31-50) 三层平台 + 高处宝物 + 第二个营地",
    "  D. 地下竞技场   (cols 51-65) 平台跳跃 + 中段法师",
    "  E. 出口走廊     (cols 66-79) 高级敌人压力测试 + 传送门"
  ],

  "layers": [
    {
      "name": "background",
      "type": "background",
      "data": [
        [4,4,4,4,4,4,4,4,4,4, 4,4,4,4,4,4,4,4,4,4, 4,4,4,4,4,4,4,4,4,4, 4,4,4,4,4,4,4,4,4,4, 4,4,4,4,4,4,4,4,4,4, 4,4,4,4,4,4,4,4,4,4, 4,4,4,4,4,4,4,4,4,4, 4,4,4,4,4,4,4,4,4,4],
        [4,0,0,0,0,0,0,0,0,0, 0,0,0,0,0,0,0,0,0,0, 0,0,0,0,0,0,0,0,0,0, 0,0,0,0,0,0,0,0,0,0, 0,0,0,0,0,0,0,0,0,0, 0,0,0,0,0,0,0,0,0,0, 0,0,0,0,0,0,0,0,0,0, 0,0,0,0,0,0,0,0,0,4],
        [4,0,0,0,0,0,0,0,0,0, 0,0,0,0,0,0,0,0,0,0, 0,0,0,0,0,0,0,0,0,0, 0,0,0,0,0,0,0,0,0,0, 0,0,0,0,0,0,0,0,0,0, 0,0,0,0,0,0,0,0,0,0, 0,0,0,0,0,0,0,0,0,0, 0,0,0,0,0,0,0,0,0,4],
        [4,0,0,0,0,0,0,0,0,0, 0,0,0,0,0,0,0,0,0,0, 0,0,0,0,0,0,0,0,0,0, 0,0,0,0,0,0,0,0,0,0, 0,0,0,0,0,0,0,0,0,0, 0,0,0,0,0,0,0,0,0,0, 0,0,0,0,0,0,0,0,0,0, 0,0,0,0,0,0,0,0,0,4],
        [4,0,0,0,0,0,0,0,0,0, 0,0,0,0,0,0,0,0,0,0, 0,0,0,0,0,0,0,0,0,0, 0,0,0,0,0,0,0,0,0,0, 0,0,0,0,0,0,0,0,0,0, 0,0,0,0,0,0,0,0,0,0, 0,0,0,0,0,0,0,0,0,0, 0,0,0,0,0,0,0,0,0,4],
        [4,0,0,0,0,0,0,0,0,0, 0,0,0,0,0,0,0,0,0,0, 0,0,0,0,0,0,0,0,0,0, 0,0,0,0,0,0,0,0,0,0, 0,0,0,0,0,0,0,0,0,0, 0,0,0,0,0,0,0,0,0,0, 0,0,0,0,0,0,0,0,0,0, 0,0,0,0,0,0,0,0,0,4],
        [4,0,0,0,0,0,0,0,0,0, 0,0,0,0,0,0,0,0,0,0, 0,0,0,0,0,0,0,0,0,0, 0,0,0,0,0,0,0,0,0,0, 0,0,0,0,0,0,0,0,0,0, 0,0,0,0,0,0,0,0,0,0, 0,0,0,0,0,0,0,0,0,0, 0,0,0,0,0,0,0,0,0,4],
        [4,0,0,0,0,0,0,0,0,0, 0,0,0,0,0,0,0,0,0,0, 0,0,0,0,0,0,0,0,0,0, 0,0,0,0,0,0,0,0,0,0, 0,0,0,0,0,0,0,0,0,0, 0,0,0,0,0,0,0,0,0,0, 0,0,0,0,0,0,0,0,0,0, 0,0,0,0,0,0,0,0,0,4],
        [4,0,0,0,0,0,0,0,0,0, 0,0,0,0,0,0,0,0,0,0, 0,0,0,0,0,0,0,0,0,0, 0,0,0,0,0,0,0,0,0,0, 0,0,0,0,0,0,0,0,0,0, 0,0,0,0,0,0,0,0,0,0, 0,0,0,0,0,0,0,0,0,0, 0,0,0,0,0,0,0,0,0,4],
        [4,0,0,0,0,0,0,0,0,0, 0,0,0,0,0,0,0,0,0,0, 0,0,0,0,0,0,0,0,0,0, 0,0,0,0,0,0,0,0,0,0, 0,0,0,0,0,0,0,0,0,0, 0,0,0,0,0,0,0,0,0,0, 0,0,0,0,0,0,0,0,0,0, 0,0,0,0,0,0,0,0,0,4],
        [4,0,0,0,0,0,0,0,0,0, 0,0,0,0,0,0,0,0,0,0, 0,0,0,0,0,0,0,0,0,0, 0,0,0,0,0,0,0,0,0,0, 0,0,0,0,0,0,0,0,0,0, 0,0,0,0,0,0,0,0,0,0, 0,0,0,0,0,0,0,0,0,0, 0,0,0,0,0,0,0,0,0,4],
        [4,0,0,0,0,0,0,0,0,0, 0,0,0,0,0,0,0,0,0,0, 0,0,0,0,0,0,0,0,0,0, 0,0,0,0,0,0,0,0,0,0, 0,0,0,0,0,0,0,0,0,0, 0,0,0,0,0,0,0,0,0,0, 0,0,0,0,0,0,0,0,0,0, 0,0,0,0,0,0,0,0,0,4],
        [4,0,0,0,0,0,0,0,0,0, 0,0,0,0,0,0,0,0,0,0, 0,0,0,0,0,0,0,0,0,0, 0,0,0,0,0,0,0,0,0,0, 0,0,0,0,0,0,0,0,0,0, 0,0,0,0,0,0,0,0,0,0, 0,0,0,0,0,0,0,0,0,0, 0,0,0,0,0,0,0,0,0,4],
        [4,0,0,0,0,0,0,0,0,0, 0,0,0,0,0,0,0,0,0,0, 0,0,0,0,0,0,0,0,0,0, 0,0,0,0,0,0,0,0,0,0, 0,0,0,0,0,0,0,0,0,0, 0,0,0,0,0,0,0,0,0,0, 0,0,0,0,0,0,0,0,0,0, 0,0,0,0,0,0,0,0,0,4],
        [4,0,0,0,0,0,0,0,0,0, 0,0,0,0,0,0,0,0,0,0, 0,0,0,0,0,0,0,0,0,0, 0,0,0,0,0,0,0,0,0,0, 0,0,0,0,0,0,0,0,0,0, 0,0,0,0,0,0,0,0,0,0, 0,0,0,0,0,0,0,0,0,0, 0,0,0,0,0,0,0,0,0,4],
        [4,0,0,0,0,0,0,0,0,0, 0,0,0,0,0,0,0,0,0,0, 0,0,0,0,0,0,0,0,0,0, 0,0,0,0,0,0,0,0,0,0, 0,0,0,0,0,0,0,0,0,0, 0,0,0,0,0,0,0,0,0,0, 0,0,0,0,0,0,0,0,0,0, 0,0,0,0,0,0,0,0,0,4],
        [4,0,0,0,0,0,0,0,0,0, 0,0,0,0,0,0,0,0,0,0, 0,0,0,0,0,0,0,0,0,0, 0,0,0,0,0,0,0,0,0,0, 0,0,0,0,0,0,0,0,0,0, 0,0,0,0,0,0,0,0,0,0, 0,0,0,0,0,0,0,0,0,0, 0,0,0,0,0,0,0,0,0,4],
        [4,0,0,0,0,0,0,0,0,0, 0,0,0,0,0,0,0,0,0,0, 0,0,0,0,0,0,0,0,0,0, 0,0,0,0,0,0,0,0,0,0, 0,0,0,0,0,0,0,0,0,0, 0,0,0,0,0,0,0,0,0,0, 0,0,0,0,0,0,0,0,0,0, 0,0,0,0,0,0,0,0,0,4],
        [4,0,0,0,0,0,0,0,0,0, 0,0,0,0,0,0,0,0,0,0, 0,0,0,0,0,0,0,0,0,0, 0,0,0,0,0,0,0,0,0,0, 0,0,0,0,0,0,0,0,0,0, 0,0,0,0,0,0,0,0,0,0, 0,0,0,0,0,0,0,0,0,0, 0,0,0,0,0,0,0,0,0,4],
        [4,4,4,4,4,4,4,4,4,4, 4,4,4,4,4,4,4,4,4,4, 4,4,4,4,4,4,4,4,4,4, 4,4,4,4,4,4,4,4,4,4, 4,4,4,4,4,4,4,4,4,4, 4,4,4,4,4,4,4,4,4,4, 4,4,4,4,4,4,4,4,4,4, 4,4,4,4,4,4,4,4,4,4],
        [4,4,4,4,4,4,4,4,4,4, 4,4,4,4,4,4,4,4,4,4, 4,4,4,4,4,4,4,4,4,4, 4,4,4,4,4,4,4,4,4,4, 4,4,4,4,4,4,4,4,4,4, 4,4,4,4,4,4,4,4,4,4, 4,4,4,4,4,4,4,4,4,4, 4,4,4,4,4,4,4,4,4,4],
        [4,4,4,4,4,4,4,4,4,4, 4,4,4,4,4,4,4,4,4,4, 4,4,4,4,4,4,4,4,4,4, 4,4,4,4,4,4,4,4,4,4, 4,4,4,4,4,4,4,4,4,4, 4,4,4,4,4,4,4,4,4,4, 4,4,4,4,4,4,4,4,4,4, 4,4,4,4,4,4,4,4,4,4],
        [4,4,4,4,4,4,4,4,4,4, 4,4,4,4,4,4,4,4,4,4, 4,4,4,4,4,4,4,4,4,4, 4,4,4,4,4,4,4,4,4,4, 4,4,4,4,4,4,4,4,4,4, 4,4,4,4,4,4,4,4,4,4, 4,4,4,4,4,4,4,4,4,4, 4,4,4,4,4,4,4,4,4,4]
      ]
    },

    {
      "name": "ground",
      "type": "ground",
      "comment": [
        "tile_id: 0=空, 1=实心地面(GROUND), 2=单向平台(PLATFORM), 3=实心墙(WALL)",
        "",
        "row 17 = 主地面（每段含 2~3 列浅坑做点缀；浅坑下方 row18~20 仍为 1 防止掉死）",
        "row 14 = 第一层平台（垂直 3 行 / 96px）",
        "row 11 = 第二层平台（再垂直 3 行 / 96px）",
        "row  8 = 第三层平台（再垂直 3 行 / 96px，仅区段 C 顶部宝物点）",
        "",
        "[可达性验证]",
        "  - 所有 row 14 平台均位于 row 17 实心区上方 → 单跳即上",
        "  - 所有 row 11 平台与 row 14 平台水平距离 ≤ 5 列",
        "  - 所有 row 8 平台与 row 11 平台水平距离 ≤ 4 列",
        "  - 所有水平浅坑 ≤ 3 列宽，玩家可直接跨越（理论极限 8 列）"
      ],
      "data": [
        [3,3,3,3,3,3,3,3,3,3, 3,3,3,3,3,3,3,3,3,3, 3,3,3,3,3,3,3,3,3,3, 3,3,3,3,3,3,3,3,3,3, 3,3,3,3,3,3,3,3,3,3, 3,3,3,3,3,3,3,3,3,3, 3,3,3,3,3,3,3,3,3,3, 3,3,3,3,3,3,3,3,3,3],
        [3,0,0,0,0,0,0,0,0,0, 0,0,0,0,0,0,0,0,0,0, 0,0,0,0,0,0,0,0,0,0, 0,0,0,0,0,0,0,0,0,0, 0,0,0,0,0,0,0,0,0,0, 0,0,0,0,0,0,0,0,0,0, 0,0,0,0,0,0,0,0,0,0, 0,0,0,0,0,0,0,0,0,3],
        [3,0,0,0,0,0,0,0,0,0, 0,0,0,0,0,0,0,0,0,0, 0,0,0,0,0,0,0,0,0,0, 0,0,0,0,0,0,0,0,0,0, 0,0,0,0,0,0,0,0,0,0, 0,0,0,0,0,0,0,0,0,0, 0,0,0,0,0,0,0,0,0,0, 0,0,0,0,0,0,0,0,0,3],
        [3,0,0,0,0,0,0,0,0,0, 0,0,0,0,0,0,0,0,0,0, 0,0,0,0,0,0,0,0,0,0, 0,0,0,0,0,0,0,0,0,0, 0,0,0,0,0,0,0,0,0,0, 0,0,0,0,0,0,0,0,0,0, 0,0,0,0,0,0,0,0,0,0, 0,0,0,0,0,0,0,0,0,3],
        [3,0,0,0,0,0,0,0,0,0, 0,0,0,0,0,0,0,0,0,0, 0,0,0,0,0,0,0,0,0,0, 0,0,0,0,0,0,0,0,0,0, 0,0,0,0,0,0,0,0,0,0, 0,0,0,0,0,0,0,0,0,0, 0,0,0,0,0,0,0,0,0,0, 0,0,0,0,0,0,0,0,0,3],
        [3,0,0,0,0,0,0,0,0,0, 0,0,0,0,0,0,0,0,0,0, 0,0,0,0,0,0,0,0,0,0, 0,0,0,0,0,0,0,0,0,0, 0,0,0,0,0,0,0,0,0,0, 0,0,0,0,0,0,0,0,0,0, 0,0,0,0,0,0,0,0,0,0, 0,0,0,0,0,0,0,0,0,3],
        [3,0,0,0,0,0,0,0,0,0, 0,0,0,0,0,0,0,0,0,0, 0,0,0,0,0,0,0,0,0,0, 0,0,0,0,0,0,0,0,0,0, 0,0,0,0,0,0,0,0,0,0, 0,0,0,0,0,0,0,0,0,0, 0,0,0,0,0,0,0,0,0,0, 0,0,0,0,0,0,0,0,0,3],
        [3,0,0,0,0,0,0,0,0,0, 0,0,0,0,0,0,0,0,0,0, 0,0,0,0,0,0,0,0,0,0, 0,0,0,0,0,0,0,0,0,0, 0,0,0,0,0,0,0,0,0,0, 0,0,0,0,0,0,0,0,0,0, 0,0,0,0,0,0,0,0,0,0, 0,0,0,0,0,0,0,0,0,3],
        [3,0,0,0,0,0,0,0,0,0, 0,0,0,0,0,0,0,0,0,0, 0,0,0,0,0,0,0,0,0,0, 0,0,0,0,0,0,0,0,2,2, 2,2,2,0,0,0,0,0,0,0, 0,0,0,0,0,0,0,0,0,0, 0,0,0,0,0,0,0,0,0,0, 0,0,0,0,0,0,0,0,0,3],
        [3,0,0,0,0,0,0,0,0,0, 0,0,0,0,0,0,0,0,0,0, 0,0,0,0,0,0,0,0,0,0, 0,0,0,0,0,0,0,0,0,0, 0,0,0,0,0,0,0,0,0,0, 0,0,0,0,0,0,0,0,0,0, 0,0,0,0,0,0,0,0,0,0, 0,0,0,0,0,0,0,0,0,3],
        [3,0,0,0,0,0,0,0,0,0, 0,0,0,0,0,0,0,0,0,0, 0,0,0,0,0,0,0,0,0,0, 0,0,0,0,0,0,0,0,0,0, 0,0,0,0,0,0,0,0,0,0, 0,0,0,0,0,0,0,0,0,0, 0,0,0,0,0,0,0,0,0,0, 0,0,0,0,0,0,0,0,0,3],
        [3,0,0,0,0,0,0,0,0,0, 0,0,0,0,0,0,0,0,0,0, 0,0,2,2,2,2,2,0,0,0, 0,0,0,0,0,2,2,2,2,0, 0,0,0,0,0,0,0,0,0,0, 0,0,0,0,0,0,0,0,0,0, 0,0,0,0,0,0,0,0,0,0, 0,0,0,0,0,0,0,0,0,3],
        [3,0,0,0,0,0,0,0,0,0, 0,0,0,0,0,0,0,0,0,0, 0,0,0,0,0,0,0,0,0,0, 0,0,0,0,0,0,0,0,0,0, 0,0,0,0,0,0,0,0,0,0, 0,0,0,0,0,0,0,0,0,0, 0,0,0,0,0,0,0,0,0,0, 0,0,0,0,0,0,0,0,0,3],
        [3,0,0,0,0,0,0,0,0,0, 0,0,0,0,0,0,0,0,0,0, 0,0,0,0,0,0,0,0,0,0, 0,0,0,0,0,0,0,0,0,0, 0,0,0,0,0,0,0,0,0,0, 0,0,0,0,0,0,0,0,0,0, 0,0,0,0,0,0,0,0,0,0, 0,0,0,0,0,0,0,0,0,3],
        [3,0,0,0,0,0,0,2,2,2, 2,0,0,0,0,0,0,0,2,2, 2,2,0,0,0,0,0,2,2,2, 2,0,0,2,2,2,2,0,0,0, 0,2,2,2,2,0,0,0,0,0, 0,0,0,2,2,2,2,0,0,0, 0,2,2,2,2,0,0,0,2,2, 2,2,2,0,0,0,0,0,0,3],
        [3,0,0,0,0,0,0,0,0,0, 0,0,0,0,0,0,0,0,0,0, 0,0,0,0,0,0,0,0,0,0, 0,0,0,0,0,0,0,0,0,0, 0,0,0,0,0,0,0,0,0,0, 0,0,0,0,0,0,0,0,0,0, 0,0,0,0,0,0,0,0,0,0, 0,0,0,0,0,0,0,0,0,3],
        [3,0,0,0,0,0,0,0,0,0, 0,0,0,0,0,0,0,0,0,0, 0,0,0,0,0,0,0,0,0,0, 0,0,0,0,0,0,0,0,0,0, 0,0,0,0,0,0,0,0,0,0, 0,0,0,0,0,0,0,0,0,0, 0,0,0,0,0,0,0,0,0,0, 0,0,0,0,0,0,0,0,0,3],
        [3,1,1,1,1,1,1,1,1,1, 1,1,1,1,1,0,0,0,1,1, 1,1,1,1,1,1,1,1,1,1, 1,1,1,1,1,1,1,1,0,0, 0,1,1,1,1,1,1,1,1,1, 1,1,1,1,1,1,0,0,1,1, 1,1,1,1,1,1,1,1,1,1, 1,1,1,1,1,1,1,1,1,3],
        [3,1,1,1,1,1,1,1,1,1, 1,1,1,1,1,1,1,1,1,1, 1,1,1,1,1,1,1,1,1,1, 1,1,1,1,1,1,1,1,1,1, 1,1,1,1,1,1,1,1,1,1, 1,1,1,1,1,1,1,1,1,1, 1,1,1,1,1,1,1,1,1,1, 1,1,1,1,1,1,1,1,1,3],
        [3,1,1,1,1,1,1,1,1,1, 1,1,1,1,1,1,1,1,1,1, 1,1,1,1,1,1,1,1,1,1, 1,1,1,1,1,1,1,1,1,1, 1,1,1,1,1,1,1,1,1,1, 1,1,1,1,1,1,1,1,1,1, 1,1,1,1,1,1,1,1,1,1, 1,1,1,1,1,1,1,1,1,3],
        [3,1,1,1,1,1,1,1,1,1, 1,1,1,1,1,1,1,1,1,1, 1,1,1,1,1,1,1,1,1,1, 1,1,1,1,1,1,1,1,1,1, 1,1,1,1,1,1,1,1,1,1, 1,1,1,1,1,1,1,1,1,1, 1,1,1,1,1,1,1,1,1,1, 1,1,1,1,1,1,1,1,1,3],
        [3,3,3,3,3,3,3,3,3,3, 3,3,3,3,3,3,3,3,3,3, 3,3,3,3,3,3,3,3,3,3, 3,3,3,3,3,3,3,3,3,3, 3,3,3,3,3,3,3,3,3,3, 3,3,3,3,3,3,3,3,3,3, 3,3,3,3,3,3,3,3,3,3, 3,3,3,3,3,3,3,3,3,3]
      ]
    }
  ],

  "objects": {
    "player_spawn": {"x": 4, "y": 16},

    "campfires": [
      {"id": "cf_graveyard_01", "x": 7,  "y": 17, "_note": "起始营地（区段 A）"},
      {"id": "cf_graveyard_02", "x": 47, "y": 17, "_note": "中段休整营地（区段 C 末尾）"},
      {"id": "cf_graveyard_03", "x": 73, "y": 17, "_note": "出口营地（区段 E 末尾）"}
    ],

    "transitions": [
      {
        "x": 77, "y": 13, "w": 2, "h": 4,
        "target_area": "area_swamp",
        "target_spawn": "default",
        "direction": "right"
      }
    ],

    "_enemy_spawns_note": "敌人配置已迁出至 data/maps/area_graveyard/enemy_spawns.json",
    "enemy_spawns": [],

    "traps": []
  }
}
